75,75,75,127,11,14,17,1,2,20,20,20,21,72,123,109,118,150,131,137,137,137,72,72,19,20,13,14,14,9,128,129,23,23,23,126,23,23,23,113,114,37,15,20,21,72,72,72,72,72,72,72,72,72,72,72,6,7,44,20,20,20,13,22,126
75,126,113,129,127,11,45,14,17,1,2,20,21,72,123,130,131,132,124,125,72,72,72,72,19,20,13,14,14,22,116,23,126,23,23,23,23,113,75,23,24,4,28,20,21,72,72,72,72,72,72,72,72,6,7,7,44,20,142,20,20,142,13,22,113
75,75,75,75,75,127,10,11,14,46,15,20,21,72,136,137,137,135,149,125,72,72,72,72,19,0,18,14,14,22,23,113,23,23,23,23,116,126,23,23,24,15,20,142,43,7,8,72,72,72,72,72,72,19,142,20,20,20,20,20,20,0,18,22,75
126,75,75,75,126,75,75,127,11,45,15,20,43,8,72,72,72,136,137,138,72,72,72,6,44,13,14,14,9,128,129,23,23,116,23,126,75,23,23,75,24,17,2,20,20,20,43,7,8,72,72,6,7,44,20,20,20,20,20,0,1,18,14,22,75
75,75,113,75,75,75,129,113,24,14,15,20,20,43,7,7,8,72,72,72,72,6,7,44,20,26,5,14,22,126,23,23,23,23,23,75,75,23,23,23,127,11,17,1,2,20,20,20,43,7,7,44,20,20,20,142,0,1,1,18,9,10,10,128,113
75,126,75,75,75,75,75,75,24,14,17,2,20,20,20,20,21,72,72,72,6,44,20,20,20,20,13,14,22,23,116,23,23,126,23,75,116,126,75,23,23,127,10,11,17,1,2,20,20,20,20,20,20,20,0,1,18,45,9,10,128,75,75,126,75
75,75,75,75,75,126,75,75,127,11,14,17,2,20,20,20,43,8,72,72,19,20,20,20,20,142,13,14,22,23,23,23,23,23,23,75,23,23,23,23,23,116,75,127,10,11,17,1,2,20,142,20,0,1,18,9,10,10,128,75,75,75,75,75,113
75,75,75,75,113,75,75,75,113,24,14,14,17,1,2,20,20,43,8,72,19,20,20,20,20,20,13,14,22,113,23,23,116,23,23,23,23,23,113,126,75,23,116,23,116,127,10,11,15,20,20,20,13,9,10,128,113,75,75,75,75,113,75,75,75
113,75,75,75,75,75,75,75,75,127,10,11,46,14,17,2,20,20,43,7,44,20,20,20,20,0,18,9,128,23,116,23,126,23,113,116,114,36,36,36,36,36,36,36,115,126,114,37,15,20,20,0,18,22,75,23,75,75,75,75,75,126,75,75,75
75,126,75,75,113,75,75,75,75,75,75,127,10,11,14,17,2,30,31,20,20,142,20,20,142,13,14,22,113,126,23,114,36,36,36,36,37,45,4,5,4,27,27,5,35,36,37,4,28,20,20,13,9,128,23,126,75,75,75,75,75,75,113,75,75
75,75,75,75,75,75,126,75,75,75,75,75,126,24,14,46,15,43,44,30,33,33,31,20,20,13,14,35,36,36,36,37,4,5,4,27,27,5,17,18,17,2,20,13,4,27,27,28,20,20,142,13,22,75,23,75,75,126,75,75,75,75,75,75,126
75,113,75,75,75,75,75,75,75,75,75,75,113,24,14,14,15,142,20,21,72,72,32,31,20,26,27,27,27,27,27,27,28,13,17,2,20,13,14,14,14,17,2,13,15,20,142,20,20,0,1,18,22,126,23,23,75,75,113,75,75,75,75,75,75
75,75,75,75,75,75,75,75,75,75,75,75,114,37,14,14,15,20,20,21,72,72,72,19,20,20,20,20,20,20,20,142,20,13,45,17,1,18,9,10,11,46,17,18,17,2,20,20,20,13,45,14,22,23,75,23,75,75,75,75,75,75,75,126,75
75,75,75,113,75,75,75,75,75,126,113,75,24,46,14,4,28,20,20,43,7,7,7,44,20,142,20,20,20,20,0,1,1,18,9,10,10,10,128,75,127,10,10,11,14,17,1,1,1,18,9,10,128,23,23,23,75,75,75,75,75,75,75,75,75
75,126,75,75,75,129,75,75,75,75,75,75,24,14,14,15,20,20,20,20,20,20,20,20,20,0,1,1,1,1,18,9,10,10,128,75,23,23,23,126,23,75,23,127,10,10,10,10,10,10,128,113,75,23,126,75,75,75,126,75,75,126,75,113,75
75,75,75,75,75,75,126,75,75,75,75,126,24,14,14,15,20,20,20,20,20,20,20,142,0,18,14,9,10,10,10,128,23,23,23,23,23,113,23,113,23,23,126,23,23,23,23,23,23,23,126,23,23,23,23,23,75,75,75,75,75,113,75,75,75
75,75,75,75,75,75,75,75,75,75,75,114,37,14,14,15,142,20,20,142,20,20,20,20,13,45,14,22,75,23,23,23,126,23,75,23,126,23,129,23,23,23,75,23,23,23,75,113,75,23,23,23,23,23,23,23,75,75,75,75,75,75,75,75,75
113,75,75,75,113,75,75,75,126,75,75,24,14,14,4,28,20,20,20,20,20,20,20,20,13,14,9,128,23,23,75,23,23,23,23,23,23,23,23,23,75,75,23,23,23,23,113,126,23,23,23,23,126,23,23,23,126,75,75,75,75,75,75,75,126
75,75,113,75,75,75,75,75,75,75,75,24,14,14,15,30,33,31,20,20,20,20,20,0,18,14,22,75,126,75,23,23,23,75,23,23,23,113,23,23,23,23,113,23,75,23,23,23,23,23,23,23,23,23,23,23,75,75,113,75,75,126,75,75,75
75,75,126,75,75,126,75,75,75,126,75,24,14,14,15,43,8,19,20,20,20,20,20,13,46,14,22,23,23,23,23,126,23,23,75,75,75,75,113,75,75,75,75,75,23,23,23,23,23,23,23,126,75,23,126,23,75,75,75,129,75,113,75,75,75
75,75,75,75,75,75,75,75,75,75,114,37,14,14,15,20,43,44,20,20,20,20,20,13,14,9,128,23,75,23,23,75,113,23,75,75,75,75,75,75,75,75,75,75,23,23,113,23,23,23,23,23,23,113,23,23,75,75,113,75,75,75,75,126,75
126,75,75,75,75,75,75,75,75,75,24,14,14,4,28,20,20,20,20,20,20,20,20,13,14,22,23,126,23,23,23,23,23,23,126,75,75,75,113,75,75,75,75,75,23,23,23,23,113,23,23,23,23,23,23,23,75,75,75,75,75,75,75,113,75
75,75,75,75,75,75,75,75,75,75,24,14,14,15,20,20,20,20,20,142,20,20,0,18,14,22,75,23,23,23,23,23,23,23,75,75,75,75,75,126,75,75,126,75,75,23,23,23,126,23,23,23,23,23,23,126,75,75,75,75,75,126,75,75,126
129,126,75,75,75,75,75,75,75,113,24,45,14,15,20,20,20,20,20,20,20,20,13,14,14,22,23,23,23,23,75,23,23,23,75,75,75,75,75,75,75,75,75,75,23,23,23,23,113,23,23,23,113,23,129,23,75,75,75,75,75,75,75,75,75
75,113,75,75,75,75,75,126,75,75,24,14,14,15,20,20,20,20,20,20,20,0,18,14,14,22,23,23,23,113,23,23,23,23,75,75,113,75,75,75,75,75,75,75,23,113,23,23,23,23,23,126,23,23,23,23,113,75,75,75,126,75,75,75,75
75,75,75,75,75,75,75,75,75,75,24,14,14,17,2,20,20,20,20,20,20,13,14,14,9,128,23,23,75,23,23,23,23,23,75,75,75,129,75,113,75,75,126,75,23,23,23,23,23,23,23,23,23,23,23,23,75,75,75,75,75,75,75,75,75
113,75,75,126,75,75,113,75,75,75,127,11,14,46,15,20,20,20,20,30,31,13,14,14,22,126,23,23,23,23,23,113,23,23,75,75,75,75,75,75,75,75,75,75,75,75,75,75,75,75,113,75,75,75,75,75,126,75,75,75,113,129,75,126,75
75,75,75,75,75,75,75,75,126,75,75,24,14,14,15,20,142,58,60,43,44,13,14,45,22,75,23,23,126,23,23,23,23,23,126,23,23,23,23,23,23,23,23,75,75,75,113,75,75,126,75,75,75,75,75,75,75,75,75,75,75,75,75,75,113
75,75,75,75,126,75,75,75,75,75,75,127,11,45,15,20,58,96,95,60,142,13,14,14,35,115,23,23,23,75,23,23,23,23,23,23,23,23,23,113,23,23,23,75,75,75,75,75,75,75,75,75,75,113,75,75,75,75,126,75,75,75,75,75,75
75,126,113,75,75,75,75,75,75,75,126,75,24,14,17,2,71,52,54,73,20,26,5,14,14,22,23,23,23,23,23,23,23,23,23,113,23,23,23,23,23,23,23,75,75,75,75,75,75,75,75,75,75,75,75,75,75,75,75,75,126,75,75,75,126
75,113,75,75,126,75,75,75,75,75,75,75,127,11,14,15,71,65,67,95,60,20,13,14,14,22,75,23,23,23,23,23,23,23,23,23,23,23,23,23,23,23,23,126,75,75,75,75,75,126,75,75,75,75,126,75,75,75,75,75,75,75,75,75,75
75,75,75,75,75,75,75,75,75,129,113,75,75,24,14,15,71,65,69,54,73,20,13,14,9,128,23,23,23,23,126,23,23,23,23,23,113,129,23,23,23,23,23,75,75,75,75,75,75,75,75,75,75,75,75,75,75,126,75,75,75,75,75,129,113
